###############
#             #
#   P         #
#       ####  #
#######    #O #
#  O ##    #  #
#    ##       #
#          ####
#       XX #
#       #  #
######### ##########################
#        X                         #
#                                  #
#OX      O                         #
####################################
